NO ./maps/textures/kotek1.xpm
SO ./maps/textures/kotek2.xpm
EA ./maps/textures/kotek3.xpm
WE ./maps/textures/kotek4.xpm

F 155,122,122
C 122,122,155

111111111111111111111
100000001001000000001
100000000100000000001
10000000100000000N001
100000000100000000001
100000000000000000001
111111111111111111111



       O       N
                0
1111    0       1
10N1    1       2
1111    2       3
        3       4
                5